It's a bright and sunny day in Littleburg, USA. The town is quiet, but the local news paper, The Daily Babler would like to see that changed, hoping to catch a big story to run. Walter Flintlock is a jorunalist at the Babler, but he's been struggling to find a good story to run. Maybe today will change all of that.

Frank Woodchuck burst into Walter Flintlock's Office, "It's almost printing time and you still don't have a story Walter! I don't pay you to sit around your office all day. Give me one reason why shouldn't fire you?"

Audio Invaders
An Interactive Fiction by Adam Magleby, Drew Facchiano, Jason Judd Roth The block giving rule is not listed in the check giving it to rules
Release 1 / Serial number 130314 / Inform 7 build 6G60 (I6/v6.32 lib 6/12N) SD

Walter's Office
Walter's office. His desk is seen here, with Photographs, Walter's Camera and a cup of coffee on it. Woodchuck, Walter's boss, is blocking the doorway to the east, staring Walter down.

To the east is the break room.

>look
Walter's Office
Walter's office. His desk is seen here, with Photographs, Walter's Camera and a cup of coffee (full) on it. Woodchuck, Walter's boss, is blocking the doorway to the east, staring Walter down.

To the east is the break room.

>east
You can't go that way.

I beg your pardon?

>e
You can't go that way.

>e
You can't go that way.

>east
You can't go that way.

* * *

I beg your pardon?

I beg your pardon?

>west
Main Office
The Main Office of the Daily Babbler. Hot tips come in and hard hitting news goes out.

>est
That's not a verb I recognise.

>e
Walter's Office
Walter's office. It is covered in photograhps that he has taken from around the town.

>e
You can't go that way.

>w
Main Office
The Main Office of the Daily Babbler. Hot tips come in and hard hitting news goes out.

>w
You can't go that way.

>n
Woodchuck's Office
Mr. Woodchuck's office. Any good journalist will try to avoid it as much as possible.

>n
You can't go that way.

>s
Main Office
The Main Office of the Daily Babbler. Hot tips come in and hard hitting news goes out.

>s
Main Street
The Main Street of Littleburg. USA. There has never been a more beautiful town than this one.

>s
Second Street
Second Street is where the industrious little town works

>s
You can't go that way.

>s
You can't go that way.

>e
East Second Street
East Second Street holds most of the homes where the good people Littleburg live.

>w
Second Street
Second Street is where the industrious little town works

* * *

>look
Walter's Office
Walter's office. His desk is seen here, with Photographs, Walter's Camera and a cup of coffee (full) on it. Woodchuck, Walter's boss, is blocking the doorway to the east, staring Walter down.

To the east is the break room.

>x
(Frank Woodchuck)
Walter's boss stares him down with a menecing stare.

* * *

>look
Walter's Office
Walter's office. His desk is seen here, with Photographs, Walter's Camera and a cup of coffee (full) on it. Woodchuck, Walter's boss, is blocking the doorway to the east, staring Walter down.

To the east is the break room.

>take camera
Walter picks up his camera ready for action. Woodchuck seems pleased with this

Walter's boss leaves the room, slaming the door shut behind him. That's Walter's cue to get to work on the next big scoop.

>look
Walter's Office
Walter's office. His desk is seen here, with Photographs and a cup of coffee (full) on it. Woodchuck, Walter's boss, is blocking the doorway to the east, staring Walter down.

To the east is the break room.

>actions
Actions listing on.

>look
[looking]
Walter's Office
Walter's office. His desk is seen here, with Photographs and a cup of coffee (full) on it. Woodchuck, Walter's boss, is blocking the doorway to the east, staring Walter down.

To the east is the break room.

[looking - succeeded]

* * *

>w
Main Office
The Main Office of the Daily Babbler. Hot tips come in and hard hitting news goes out.

>s
Main Street
The Main Street of Littleburg. USA. There has never been a more beautiful town than this one.

>go in malt shop
You can't see any such thing.

>enter malt shop
You can't see any such thing.

>enter Malt Shop
You can't see any such thing.

>inside Malt Shop
I only understood you as far as wanting to inside.

>go inside the Malt Shop
You can't see any such thing.

>go inside
Malt Shop
A fancy malt shop.

>go outside
Main Street
The Main Street of Littleburg. USA. There has never been a more beautiful town than this one.

* * *

>w
Main Office
The Main Office of the Daily Babbler. Hot tips come in and hard hitting news goes out.

>n
Woodchuck's Office
Mr. Woodchuck's office. Any good journalist will try to avoid it as much as possible.

>s
Main Office
The Main Office of the Daily Babbler. Hot tips come in and hard hitting news goes out.

* * *

>e
Woodchuck blocks Walter from leaving the room. Walter better think of something to get him to leave.

>e
Office Supply Room
A room filled with random office supplies.

I CANT SPEAK!

>w
Break Room
A place where employee's converse on the latest gossip around the town.

I CAN SPEAK!

>e
Office Supply Room
A room filled with random office supplies.

>w
Break Room
A place where employee's converse on the latest gossip around the town.

* * *

>e
Woodchuck blocks Walter from leaving the room. Walter better think of something to get him to leave.

>x water cooler
A cooler that dispenses water.

* * *

>e
Woodchuck blocks Walter from leaving the room. Walter better think of something to get him to leave.

>x cooler
A cooler that dispenses water.

>x water cooler
A cooler that dispenses water.

>x water
A cooler that dispenses water.

>x wa
You can't see any such thing.

>x water
A cooler that dispenses water.

>x cooler
A cooler that dispenses water.

* * *

>e
Woodchuck blocks Walter from leaving the room. Walter better think of something to get him to leave.

>take cooler
That's hardly portable.

>w
Walter's Office
Walter's office. It is covered in photograhps that he has taken from around the town. To the east is the break room.

* * *

>e
Woodchuck blocks Walter from leaving the room. Walter better think of something to get him to leave.

>w
You can't go that way.

>look
Walter's Office
Walter's office. It is covered in photograhps that he has taken from around the town.

To the east is the break room.

* * *

>w
You can't go that way.

>actions
Actions listing on.

>look
[looking]
Walter's Office
Walter's office. It is covered in photograhps that he has taken from around the town.

To the east is the break room.

Walter's boss, a man with a stare that would crush the heart of any journalist. He is very hard to convince about even the simplest of things.

[looking - succeeded]

* * *

>e
Woodchuck blocks Walter from leaving the room. Walter better think of something to get him to leave.

>drink
(the water cooler)
Walter takes a small paper cup, and poors himself a drink of water. Ah refreshing!

>take drink from water cooler
Walter gets a small paper cup, and poor himself a drink of water from the cooler.

>take a drink
You can't see any such thing.

>take water cooler
That's hardly portable.

>drink from water
Walter gets a small paper cup, and poor himself a drink of water from the cooler.

>drink walter
You can't see any such thing.

>drink self
There's nothing suitable to drink here.

* * *

>e
Woodchuck blocks Walter from leaving the room. Walter better think of something to get him to leave.

>drink self
There's nothing suitable to drink here.

>drink the player
You can't see any such thing.

>take a drink from the player
You can't see any such thing.

>take from from player
You can't see any such thing.

>actions
Actions listing on.

>take drink from player
You can't see any such thing.

>take drink from cooler
[taking a drink the water cooler]
Walter gets a small paper cup, and poor himself a drink of water from the cooler. Ah, refreshing.
[taking a drink the water cooler - succeeded]

>drink water
[drinking the water cooler]
There's nothing suitable to drink here.
[drinking the water cooler - failed the block drinking rule]

* * *

>e
Woodchuck blocks Walter from leaving the room. Walter better think of something to get him to leave.

>drink water
There's nothing suitable to drink here.

>drink
(the water cooler)
There's nothing suitable to drink here.

>drink the water cooler
There's nothing suitable to drink here.

* * *

>drink water
There's nothing suitable to drink here.

>drink water cooler
There's nothing suitable to drink here.

>drink water cooler
There's nothing suitable to drink here.

>drink
(the water cooler)
There's nothing suitable to drink here.

* * *

>drink the water cooler
There's nothing suitable to drink here.

>look
Break Room
A place where employee's converse on the latest gossip around the town. There is a water cooler with a small refridgerator next to it.

Walter's office is to the west, the office supply room is to the east, and the Daily Babler foyer is to the south.

You can see a water cooler here.

>action
That's not a verb I recognise.

>actions
Actions listing on.

>drink water cooler
[drinking the water cooler]
There's nothing suitable to drink here.
[drinking the water cooler - failed the block drinking rule]

>x water cooler
[examining the water cooler]
A cooler that dispenses water.

[examining the water cooler - succeeded]

>take water cooler
[taking the water cooler]
Taken.
[taking the water cooler - succeeded]

>drink water cooler
[drinking the water cooler]
There's nothing suitable to drink here.
[drinking the water cooler - failed the block drinking rule]

>drop water cooler
[dropping the water cooler]
Dropped.
[dropping the water cooler - succeeded]

>look
[looking]
Break Room
A place where employee's converse on the latest gossip around the town. There is a water cooler with a small refridgerator next to it.

Walter's office is to the west, the office supply room is to the east, and the Daily Babler foyer is to the south.

You can see a water cooler here.

[looking - succeeded]

* * *

>drink water cooler
There's nothing suitable to drink here.

>take drink of water cooler
Walter gets a small paper cup, and poor himself a drink of water from the cooler. Ah, refreshing.

taking a drink of water cooler.

>actions
Actions listing on.

>i
[taking inventory]
You are carrying nothing.

[taking inventory - succeeded]

>drink water
[drinking the water cooler]
There's nothing suitable to drink here.
[drinking the water cooler - failed the block drinking rule]

>take drink of self
[drink yourself]
Walter knows he can't drink that.
[drink yourself - failed the Check drink when the noun is not drinkable]

* * *

>drink water
There's nothing suitable to drink here.

>take drink
You can't see any such thing.